-                                                                                                                      -
-                                                                                                                      -
-                                                                                                                      -
-                                                                                                                      -
-                                                                                                                      -
-                                                                                                                      -
-                                                                                                                      -
-                                                                                                                      -
-                                                                                                                      -
- S  ****                                                                                                              -
------------------------------------------------------------------------------------------------------------------------