-                                                                                                                      -
-                                                                                                                      -
-                                                                                                                      -
-                                                                                                                      -
-                                                                                                                      -
-                                                                                                                      -
-                                                                                                                      -
-                                                                                                                      -
-                                                                                                                      -
- S  **                                                                                                                -
------------------------------------------------------------------------------------------------------------------------