-                                                                                                                      -
-                                                                                                                      -
-                                                                                                                      -
-                                                                                                                      -
-                                                                                                                      -
-                                                                                                                      -
-           -----                                                                                                      -
-                                                                                                                      -
-                                                                                                                      -
- S  -------                                                                                                           -
------------------------------------------------------------------------------------------------------------------------