--------------------------------------------------
-                    -----------------------------
-                    -----------------------------
-                    -----------------------------
-            --      -----------------------------
-                    -----------------------------
--                                       -       -
-                                                -
-                   ---                          -
-                            ---      F          -
-                    -----------------------------
-      ---           -----------------------------
-                         ------------------------
-   -----------             ----------------------
-                           ----------------------
-                -                  --------------
-                               --------         -
-                                                -
-  S                                             -
- --                                             -
-                                                -
-                                                -
-                                                -
-                                                -
-                                                -
-                                                -
-                                                -
-                                                -
-                                                -
-                                                -
-                                                -
-                                                -
-                                                -
-                                                -
-                                                -
-                                                -
-                                                -
-                                                -
-                                                -

---------------------  ---------------------------