-                                                                                                                      -
-                                                                                                                      -
-                                                                                                                      -
-                                                                                                                      -
-                                                                                                                      -
-                                                                                                                      -
-                                                                                                                      -
-                                                                                                                     -
-                                                                                                                     -
- S                                                                                                                    -
------------------------------------------------------------------------------------------------------------------------