--------------------------------------------------
-                    -----------------------------
-                    -----------------------------
-                    -----------------------------
-            --      -----------------------------
-                    -----------------------------
--                                       -        -
-                                                -
-                   ---                          -
-                            ---                 -
-                    -----------------------------
-      ---           -----------------------------
-                    -----------------------------
-   -----------      -----------------------------
-                    -----------------------------
-                -   -----------------------------
-                   --------------------         -
-                                                -
-  S                                             -
--------------------------------------------------