--------------------------------------------------
-                    -----------------------------
-                    -----------------------------
-                    -----------------------------
-            --      -----------------------------
-                    -----------------------------
--                                       -        -
-                                                -
-                   ---                          -
-                            ---                 -
-                    -----------------------------
-      ---           -----------------------------
-                         ------------------------
-   -----------             ----------------------
-                           ----------------------
-                -                  ------------------
-                               --------         -
-                                                -
-  S                                             -
- --                                             -
-                                                -
-                                                -
-                                                -
-                                                -
-                                                -
-                                                -
-                                                -
-                                                -
-                                                -
-                                                -
-                                                -
-                                                -
-                                                -
-                                                -
-                                                -
-                                                -
-                                                -
-                                                -
-                                                -

---------------------  ---------------------------