-                                                                                                                      -
-                                                                                                                      -
-                                                                                                                      -
-                                                                                                                      -
-                                                                                                                      -
-                                                                                                                      -
-                                                                                                                      -
-                                                                                                                      -
-                                                                                                                      -
- S  *****                                                                                                             -
------------------------------------------------------------------------------------------------------------------------
